Merger Agr.	Merger/Acquisition Agmt.
Amendment	Amendment
Employment Agr.	Employment Agmt.
Marketing Agr.	Marketing Agmt.
Assignment & Assump. Agmt	Assignment & Assumption Agmt.
At-the-market Offering Agr.	At-the-market Offering Agmt.
Distribution Agr.	Distribution Agmt.
Indemnity Agr.	Indemnity Agmt.
Revolving Credit Agr.	Revolving Credit Agmt.
Stock Option Agr.	Stock Option Agmt.
Sales Agr.	Sales Agmt.
Collateral Pledge Agr.	Collateral Pledge Agmt.
Registration Rights Agr.	Registration Rights Agmt.
Release	Release
Stock Purchase Agr.	Stock Purchase Agmt.
Subscription Agr.	Subscription Agmt.
Tax Sharing Agr.	Tax Sharing Agmt.
License Agr.	License
Work Order	Work Order
Plan of Reorganization	Plan of Reorganization
Conversion Agr.	Conversion Agmt.
Bridge Loan Agr.	Bridge Loan Agmt.
Warrant	Warrant
Term Loan Agr.	Term Loan Agmt.
Loan Agr.	Loan Agmt.
Confidentiality/NDR Agr.	Confidentiality/Non-Disclosure Agmt.
Non-Compete Agr.	Non-Compete Agmt.
Consulting Services Agr.	Consulting Services Agmt.
Severance Agr.	Severance Agmt.
Intellectual Property Agr.	Intellectual Property Agmt.
Separation Agr.	Separation Agmt.
Settlement Agr.	Settlement Agmt.
Oil Supply/Throughput Agr.	Oil Supply/Throughput Agmt.
Services Agr.	Services Agmt.
Investment Mgmt Agr.	Investment Management Agmt.
Termination Agr.	Termination Agmt.
Transition Services Agr.	Transition Services Agmt.
Addendum	Addendum
Manufacturing Agr.	Manufacturing Agmt.
Supply Agr.	Supply Agmt.
Promissory Note	Promissory Note
Patent License Agr.	Patent License Agmt.
Franchise Agr.	Franchise Agmt.
Research & Development Agr.	R&D Agmt.
Software License Agr.	Software License Agmt.
Development Agr.	Development Agmt.
Operations & Maintenance Agr.	Operations & Maintenance Agmt.
Novation Agr.	Novation Agmt.
Financing Agr.	Financing Agmt.
Joint Venture Agr.	Joint Venture Agmt.
Note Purchase Agr.	Note Purchase Agmt.
Guarantee	Guarantee
Investor Rights Agr.	Investor Rights Agmt.
Land Lease	Land Lease
Asset Purchase Agr.	Asset Purchase Agmt.
Equity/Note Distribution Agr.	Equity/Note Distribution Agmt.
Retail Lease	Retail Lease
Standstill Agr.	Standstill Agmt.
Equipment Lease	Equipment Lease
Office Lease	Office Lease
Content License Agr.	Content License Agmt.
Mezzanine Loan Agr.	Mezzanine Loan Agmt.
Job Creation Agr.	Job Creation Agmt.
Royalty Agr.	Royalty Agmt.
Consignment Agr.	Consignment Agmt.
Option Agreement	Option Agmt.
